01 01 01 01 01 01 01 01 01 01 01 01 01 01 01 01 01 01 
01 01 01 01 01 01 01 01 01 01 01 01 01 01 01 01 01 01 
01 01 00 00 09 03 03 03 03 03 03 00 00 00 00 00 01 01 
01 01 01 04 01 01 03 03 03 03 03 00 08 00 00 00 01 01 
01 01 00 00 03 03 03 03 03 03 03 00 08 00 07 00 01 01 
01 01 00 00 01 01 03 03 03 03 03 08 01 01 01 00 01 01 
01 01 00 00 01 01 01 01 02 02 01 01 01 00 00 00 01 01 
01 01 00 00 01 01 00 00 00 00 01 00 00 00 00 00 01 01 
01 01 00 00 01 01 00 00 00 00 00 00 00 00 00 00 01 01 
01 01 12 00 01 01 00 00 05 00 01 11 00 00 00 06 01 01 
01 01 01 01 01 01 01 01 01 01 01 01 01 01 01 01 01 01 
01 01 01 01 01 01 01 01 01 01 01 01 01 01 01 01 01 01 