01 01 01 01 01 01 01 01 01 01 01 01 01 01 01 01 01 01 
01 12 01 09 01 03 01 03 00 00 00 00 00 00 08 00 00 01 
01 03 03 03 03 03 01 03 07 00 08 00 08 00 08 00 00 01 
01 01 01 10 01 03 01 03 01 01 01 01 01 01 01 00 00 01 
01 06 01 00 01 03 01 03 01 00 00 00 00 00 00 00 00 01 
01 03 01 00 01 03 01 03 01 00 00 03 01 01 01 01 01 01 
01 00 01 00 01 03 01 03 01 00 00 00 00 00 00 09 00 01 
01 00 01 00 01 03 01 03 01 01 01 01 00 01 01 09 01 01 
01 00 01 00 01 03 01 03 03 03 03 01 00 00 01 04 01 01 
01 00 01 00 01 03 01 01 01 01 03 01 00 00 01 00 00 01 
01 00 00 00 01 03 03 03 03 03 03 01 00 03 00 11 00 01 
01 01 01 01 01 01 01 01 01 01 01 01 01 05 01 01 01 01 