01 01 01 01 01 01 01 01 01 01 01 01 01 01 01 01 01 01 
01 00 09 00 00 07 00 07 00 01 00 00 00 00 00 00 00 01 
01 00 03 00 00 03 00 01 00 01 09 09 09 09 00 00 00 01 
01 00 07 00 00 03 00 02 00 01 03 03 03 09 03 03 00 01 
01 00 03 03 03 03 00 00 00 01 03 03 03 03 03 03 12 01 
01 03 03 03 08 08 00 00 00 01 03 03 03 03 03 03 00 01 
01 00 00 03 03 03 00 00 00 01 00 00 00 00 00 00 00 01 
01 00 00 03 00 00 00 00 00 01 00 00 00 07 00 07 00 01 
01 00 00 01 00 00 00 00 00 02 02 08 03 03 03 03 03 01 
01 10 00 03 00 00 00 00 00 00 00 03 03 00 00 00 00 01 
01 10 00 01 01 09 01 05 09 01 01 02 03 00 00 00 10 01 
01 01 01 01 01 01 01 01 01 01 01 01 01 01 01 01 01 01 