01 01 01 01 01 01 01 01 01 01 01 01 01 01 01 01 01 01 
01 12 09 00 02 02 03 03 01 03 03 03 03 03 03 03 03 01 
01 03 02 00 02 02 03 03 01 03 03 03 03 03 03 03 03 01 
01 03 02 10 02 03 03 03 01 03 03 03 03 03 03 03 03 01 
01 03 02 09 02 03 03 03 01 03 03 03 03 07 03 03 03 01 
01 03 02 09 02 03 03 03 01 03 03 03 03 03 03 03 03 01 
01 03 02 09 02 03 03 03 01 03 07 03 03 03 03 03 03 01 
01 03 02 09 02 03 03 03 01 03 03 03 07 03 03 03 03 01 
01 03 02 02 02 03 03 03 01 03 03 03 03 03 03 03 07 01 
01 03 02 00 02 03 03 03 04 03 03 03 03 03 03 03 03 01 
01 03 02 06 02 03 03 03 01 03 03 03 03 03 03 03 05 01 
01 01 01 01 01 01 01 01 01 01 01 01 01 01 01 01 01 01 