01 01 01 01 01 01 01 01 01 01 01 01 01 01 01 01 01 01 
01 12 00 00 00 04 08 00 00 00 00 00 00 08 00 00 00 01 
01 00 00 00 00 02 02 00 00 00 00 02 02 02 00 00 00 01 
01 00 00 00 00 00 00 00 00 00 00 02 02 02 09 02 02 01 
01 00 00 00 00 00 00 00 00 00 00 02 00 02 02 02 00 01 
01 00 00 00 00 00 00 00 00 00 00 02 00 00 00 00 06 01 
01 01 01 01 01 01 01 00 01 01 01 01 01 01 01 01 01 01 
01 03 03 03 03 03 01 00 01 00 00 00 00 00 00 00 00 01 
01 03 03 03 03 03 01 00 01 00 07 00 00 00 00 00 00 01 
01 03 03 03 03 03 01 00 01 00 07 00 00 00 00 00 00 01 
01 03 03 03 03 03 01 09 02 00 07 00 00 00 00 00 10 01 
01 01 01 01 01 01 01 01 01 01 01 01 05 01 01 01 01 01 