01 01 01 01 01 01 01 01 01 01 01 01 01 01 01 01 01 01 
01 00 00 00 09 04 00 02 02 02 02 02 02 02 02 02 02 01 
01 00 02 02 02 02 00 02 02 02 02 02 02 02 02 02 02 01 
01 00 00 00 00 00 00 02 02 03 03 03 03 03 03 02 02 01 
01 12 00 00 00 00 00 09 02 03 07 03 03 03 03 02 02 01 
01 03 03 03 03 03 02 02 02 03 03 03 03 03 03 02 02 01 
01 03 03 03 03 03 02 02 02 03 03 03 07 03 03 02 02 01 
01 03 03 08 08 08 02 02 02 03 03 03 03 03 03 02 02 01 
01 03 03 03 03 03 02 02 02 03 07 03 03 03 03 02 02 01 
01 03 03 08 03 03 02 02 02 03 03 03 03 03 03 02 02 01 
01 03 03 08 03 06 02 02 02 03 03 03 03 03 03 02 02 01 
01 01 01 01 01 01 01 01 01 01 01 01 01 01 05 01 01 01 