01 01 01 01 01 01 01 01 01 01 01 01 01 01 01 01 01 01 
01 00 00 00 00 00 00 04 00 00 00 00 00 09 00 00 00 01 
01 03 03 03 03 03 03 03 03 03 03 03 03 03 03 03 03 01 
01 00 00 00 00 00 00 00 00 00 00 00 00 00 00 00 00 01 
01 00 00 00 00 00 00 00 00 00 00 09 09 09 09 09 09 01 
01 00 00 00 00 00 00 00 00 00 00 03 03 03 03 03 03 01 
01 00 00 00 00 00 00 00 00 00 00 00 00 00 00 00 00 01 
01 00 00 00 00 00 00 07 00 00 00 02 02 02 02 02 02 01 
01 00 00 00 00 02 02 02 02 02 02 02 00 00 00 00 00 01 
01 00 00 00 00 02 02 02 02 02 02 02 00 00 00 00 00 01 
01 12 00 00 08 09 02 02 02 02 02 02 00 00 00 06 00 01 
01 01 01 05 01 01 01 01 01 01 01 01 01 01 01 01 01 01 