01 01 01 01 01 01 01 01 01 01 01 01 01 01 01 01 01 01 
01 00 00 01 01 01 00 01 01 01 01 01 00 01 01 01 09 01 
01 00 00 09 02 00 00 09 02 09 02 00 00 09 02 00 03 01 
01 00 00 03 02 00 00 03 02 03 02 00 00 03 02 00 00 01 
01 12 00 01 01 01 00 01 01 01 01 01 00 01 01 01 02 01 
01 01 01 01 01 01 01 01 01 01 01 01 01 01 01 01 00 01 
01 00 00 00 00 00 00 00 00 00 00 00 00 00 00 07 00 01 
01 00 00 00 00 00 00 00 07 00 03 01 01 01 01 01 00 01 
01 01 01 01 01 00 01 01 01 01 00 00 00 01 09 00 00 01 
01 10 02 10 01 00 01 02 09 09 00 00 00 02 03 00 00 01 
01 02 11 02 01 00 07 02 01 03 00 00 00 02 03 00 00 01 
01 01 01 01 01 05 01 01 01 01 01 01 01 01 01 01 01 01 