01 01 01 01 01 01 01 01 01 01 01 01 01 01 01 01 01 01 
01 02 02 02 00 00 09 00 00 00 02 02 02 00 09 00 00 01 
01 02 02 02 00 02 02 02 02 00 02 02 02 00 01 01 00 01 
01 02 00 00 00 02 02 02 02 00 02 00 00 00 07 00 00 01 
01 00 00 02 02 00 02 02 02 00 02 00 02 03 02 02 00 01 
01 00 00 02 02 00 00 00 00 00 02 00 02 00 02 02 00 01 
01 00 00 02 02 02 02 02 02 00 00 00 02 02 02 07 00 01 
01 00 00 00 00 00 10 00 00 00 02 05 01 02 02 02 00 01 
01 00 00 02 02 02 02 02 02 00 02 02 02 02 02 02 10 01 
01 12 00 02 02 02 02 02 02 00 02 02 02 02 02 02 00 01 
01 00 00 02 02 02 02 02 02 00 00 00 00 00 00 00 00 01 
01 01 01 01 01 01 01 01 01 01 01 01 01 01 01 01 01 01 