01 01 01 01 01 01 01 01 01 01 01 01 01 01 01 01 01 01 
01 00 00 00 00 00 00 00 00 00 00 00 00 00 00 00 00 01 
01 00 12 00 00 00 00 00 00 00 00 00 00 00 00 00 00 01 
01 00 00 01 03 03 03 08 03 03 03 03 03 03 01 00 00 01 
01 00 00 01 03 03 03 03 03 03 03 03 03 03 01 00 00 01 
01 00 00 01 03 03 03 03 03 03 03 03 03 03 01 00 00 01 
01 00 00 01 00 07 00 00 00 00 00 00 00 00 01 00 00 01 
01 01 01 01 01 01 01 01 01 01 00 01 01 05 01 01 01 01 
01 02 02 02 02 02 02 02 02 01 01 01 02 02 02 02 02 01 
01 02 02 02 02 02 02 02 02 02 02 02 02 02 02 02 02 01 
01 02 02 02 02 02 02 02 02 02 02 02 02 02 02 02 02 01 
01 01 01 01 01 01 01 01 01 01 01 01 01 01 01 01 01 01 