01 01 01 01 01 01 01 01 01 01 01 01 01 01 01 01 01 01 
01 00 00 00 00 00 00 00 00 01 02 01 00 00 01 02 02 01 
01 00 07 00 07 00 07 00 09 01 02 01 01 00 00 01 02 01 
01 09 01 01 01 01 03 03 03 01 01 01 02 01 00 00 01 01 
01 00 01 01 03 03 03 03 03 07 00 01 02 02 01 00 00 01 
01 00 01 03 03 03 03 02 02 02 00 01 01 02 02 01 00 01 
01 00 01 03 08 03 02 02 02 02 00 01 00 01 02 02 01 01 
01 00 03 03 03 03 03 03 03 07 00 01 00 00 01 02 02 01 
01 00 01 09 09 09 09 09 09 09 00 01 01 00 00 01 02 01 
01 00 01 01 01 01 01 01 01 01 00 01 02 01 00 00 01 01 
01 02 12 00 00 00 00 00 00 00 05 01 02 02 01 00 00 01 
01 01 01 01 01 01 01 01 01 01 01 01 01 01 01 01 01 01 