01 01 01 01 01 01 01 01 01 01 01 01 01 01 01 01 01 01 
01 00 00 08 00 08 00 08 00 01 01 01 00 01 00 09 03 01 
01 00 00 08 00 03 00 03 06 01 01 01 00 01 00 01 03 01 
01 09 09 01 01 01 01 01 01 01 02 02 00 01 00 01 03 01 
01 03 03 03 03 03 03 03 03 03 02 01 00 01 00 01 03 01 
01 03 03 03 03 03 03 03 03 03 03 03 00 01 00 01 03 01 
01 02 02 02 01 01 01 01 01 01 01 01 00 01 00 01 03 01 
01 03 03 03 03 03 01 10 01 01 01 01 00 01 00 01 03 01 
01 03 07 03 07 03 01 00 10 00 10 01 00 01 00 01 03 01 
01 03 01 03 01 03 01 00 00 00 00 01 00 01 00 01 03 01 
01 03 03 03 03 03 04 00 00 00 00 01 00 02 10 01 12 01 
01 01 01 01 01 01 01 01 01 01 05 01 01 01 01 01 01 01 