01 01 01 01 01 01 01 01 01 01 01 01 01 01 01 01 01 01 
01 09 01 03 03 03 01 00 01 00 09 08 00 00 00 08 00 01 
01 03 03 03 01 03 03 03 03 03 03 01 03 03 03 03 00 01 
01 00 01 01 01 01 01 01 01 01 03 01 01 01 00 00 00 01 
01 00 00 00 00 00 00 00 00 00 03 03 03 07 00 07 00 01 
01 02 01 03 07 03 00 00 00 00 03 08 12 07 00 07 00 01 
01 03 01 01 01 01 00 00 00 00 03 01 01 01 00 03 00 01 
01 03 03 03 01 00 00 00 00 00 03 01 03 03 03 03 03 01 
01 03 06 03 01 00 00 00 00 00 03 01 03 00 00 00 00 01 
01 01 01 01 01 00 00 07 00 00 03 04 03 07 00 00 00 01 
01 03 03 03 03 03 03 03 03 03 03 03 03 05 00 08 00 01 
01 01 01 01 01 01 01 01 01 01 01 01 01 01 01 01 01 01 