01 01 01 01 01 01 01 01 01 01 01 01 01 01 01 01 01 01 
01 00 08 00 01 03 03 01 08 08 00 00 08 00 01 00 07 01 
01 00 01 00 01 03 03 03 03 01 00 00 01 00 01 00 07 01 
01 00 01 00 01 03 03 01 00 01 00 00 01 00 01 00 07 01 
01 00 01 00 01 09 03 01 00 01 00 00 01 00 01 00 07 01 
01 00 01 00 01 01 03 01 10 02 00 00 01 00 01 00 04 01 
01 00 01 00 01 00 00 01 01 01 00 00 01 10 02 00 00 01 
01 00 01 00 01 00 00 00 00 01 00 01 01 01 01 00 00 01 
01 00 01 00 02 00 00 00 00 01 00 01 00 06 01 00 00 01 
01 00 01 00 02 00 00 00 00 01 00 01 00 00 01 00 00 01 
01 12 01 10 01 01 00 00 00 01 09 02 00 00 01 00 05 01 
01 01 01 01 01 01 01 01 01 01 01 01 01 01 01 01 01 01 