01 01 01 01 01 01 01 01 01 01 01 01 01 01 01 01 01 01 
01 09 03 03 03 03 03 03 03 03 03 03 03 03 03 03 12 01 
01 03 03 01 01 01 01 01 01 01 01 01 01 01 01 01 01 01 
01 03 01 01 01 01 00 07 00 00 00 00 00 03 08 08 08 01 
01 03 01 01 01 01 00 01 00 00 00 00 00 03 00 00 00 01 
01 03 01 01 01 01 00 00 08 00 00 00 00 03 03 03 03 01 
01 03 01 01 01 01 00 00 03 00 07 00 00 03 00 00 06 01 
01 03 03 03 01 01 00 00 00 00 01 00 00 03 00 00 00 01 
01 00 02 01 01 01 00 00 00 01 00 00 00 03 00 00 00 01 
01 00 02 02 02 01 00 00 01 00 00 00 00 03 00 00 00 01 
01 00 02 00 00 00 00 01 00 04 00 00 00 03 10 10 10 01 
01 01 01 01 01 01 01 01 05 01 01 01 01 01 01 01 01 01 