01 01 01 01 01 01 01 01 01 01 01 01 01 01 01 01 01 01 
01 12 03 03 03 03 02 00 00 02 02 02 02 02 00 00 00 01 
01 02 02 02 02 03 02 00 00 02 00 00 00 00 00 07 00 01 
01 03 03 03 03 03 07 00 00 02 00 00 00 00 02 02 02 01 
01 02 03 02 03 02 02 00 00 02 00 00 00 07 00 00 10 01 
01 03 03 03 08 03 03 00 00 02 00 02 00 02 00 00 00 01 
01 03 02 02 02 03 03 00 02 02 00 02 00 00 00 00 00 01 
01 03 03 03 03 03 07 00 00 02 00 02 00 00 00 00 00 01 
01 03 03 03 03 02 02 00 00 02 00 02 02 00 00 00 00 01 
01 03 02 03 02 03 03 00 02 02 00 00 02 00 00 00 00 01 
01 03 02 06 02 03 03 00 00 04 10 00 00 00 00 00 00 01 
01 01 01 01 01 01 01 01 01 01 01 01 01 01 01 01 05 01 