01 01 01 01 01 01 01 01 01 01 01 01 01 01 01 01 01 01 
01 06 00 00 10 02 03 03 03 03 03 08 03 03 03 08 03 01 
01 00 00 00 00 02 03 03 03 03 03 09 03 03 03 03 03 01 
01 00 00 00 00 02 03 03 03 03 03 04 03 03 03 03 03 01 
01 00 00 00 00 03 03 03 03 03 03 03 03 03 03 03 03 01 
01 11 00 00 00 03 03 03 03 03 03 03 03 03 03 03 03 01 
01 02 02 02 02 02 03 03 03 03 03 03 03 03 03 03 03 01 
01 03 03 03 03 03 03 03 07 03 03 02 03 03 07 03 03 01 
01 03 03 03 03 03 03 02 02 02 02 02 02 02 02 03 03 01 
01 03 03 03 03 03 03 02 03 03 03 03 03 03 03 03 03 01 
01 12 03 03 03 03 03 02 03 08 03 08 08 08 08 03 08 01 
01 01 01 01 01 01 01 01 05 01 01 01 01 01 01 01 01 01 