01 01 01 01 01 01 01 01 01 01 01 01 01 01 01 01 01 01 
01 03 03 03 03 03 03 03 03 03 03 03 03 03 03 03 07 01 
01 03 07 08 03 03 03 03 07 03 03 03 07 03 03 07 08 01 
01 03 08 08 03 03 07 03 08 03 06 03 08 03 07 08 09 01 
01 03 09 08 07 03 08 03 09 03 07 03 09 03 08 09 03 01 
01 03 03 09 08 03 09 03 03 03 08 03 03 03 09 03 03 01 
01 03 03 03 09 03 03 03 03 03 09 03 03 03 03 03 03 01 
01 03 03 03 03 03 03 03 03 03 03 03 03 03 03 03 03 01 
01 03 03 03 03 03 03 03 03 03 03 03 03 03 03 03 03 01 
01 12 03 03 03 03 03 03 03 03 03 03 03 03 03 03 03 01 
01 02 02 02 02 02 02 02 02 02 02 02 02 02 02 04 02 01 
01 01 01 01 01 01 01 01 01 01 01 01 01 01 01 01 05 01 