01 01 01 01 01 01 01 01 01 01 01 01 01 01 01 01 01 01 
01 00 00 00 00 00 03 03 03 03 03 03 03 03 02 03 03 01 
01 00 00 00 00 00 00 07 00 07 00 07 00 03 02 03 12 01 
01 00 00 00 00 00 03 03 03 03 03 03 03 03 02 03 03 01 
01 00 00 00 00 00 00 08 00 08 00 08 00 03 02 03 03 01 
01 00 00 00 00 00 03 03 03 03 03 03 03 03 02 03 03 01 
01 00 00 00 00 00 03 03 03 03 03 03 03 03 02 03 03 01 
01 00 00 00 00 00 03 03 03 03 03 03 03 03 03 03 03 01 
01 00 03 03 02 00 02 03 03 03 03 03 03 03 02 03 03 01 
01 04 03 03 02 00 02 03 03 03 03 03 03 03 02 03 03 01 
01 05 03 03 02 00 02 06 03 03 03 03 03 03 02 03 03 01 
01 01 01 01 01 01 01 01 01 01 01 01 01 01 01 01 01 01 