01 01 01 01 01 01 01 01 01 01 01 01 01 01 01 01 01 01 
01 03 03 03 03 03 03 03 08 00 02 00 04 00 00 00 00 01 
01 03 01 01 01 01 01 01 01 00 02 00 01 01 01 01 05 01 
01 03 01 00 00 00 00 00 01 00 02 00 01 00 00 00 00 01 
01 03 01 00 00 00 00 00 01 00 02 00 01 00 06 01 00 01 
01 03 01 00 00 00 12 00 01 00 02 00 01 01 01 01 00 01 
01 03 00 00 00 00 00 00 01 00 02 00 00 00 00 00 00 01 
01 03 01 00 00 00 00 00 01 00 02 00 01 01 01 01 01 01 
01 03 01 00 00 00 00 00 01 00 02 00 01 00 00 00 00 01 
01 03 01 01 01 01 01 01 01 00 02 00 01 01 01 01 00 01 
01 03 03 03 03 03 03 03 03 10 02 00 00 00 00 00 00 01 
01 01 01 01 01 01 01 01 01 01 01 01 01 01 01 01 01 01 