01 01 01 01 01 01 01 01 01 01 01 01 01 01 01 01 01 01 
01 00 00 00 00 00 00 01 00 00 09 00 07 00 01 09 10 01 
01 00 01 00 00 00 00 01 00 00 03 00 01 00 01 09 09 01 
01 00 01 00 09 09 00 01 00 01 00 01 01 00 01 01 01 01 
01 03 01 03 03 03 03 01 00 00 06 00 03 00 00 00 00 01 
01 00 01 01 00 00 01 01 00 01 01 01 01 04 01 00 00 01 
01 00 00 01 00 00 01 00 00 00 00 00 00 03 03 00 00 01 
01 00 00 01 00 00 01 00 01 01 01 01 01 00 01 01 00 01 
01 00 00 01 00 00 01 00 01 08 01 08 01 00 00 01 00 01 
01 01 03 01 00 00 01 01 01 03 03 03 01 01 00 01 00 01 
01 12 00 01 02 02 03 00 00 03 01 03 00 00 00 01 05 01 
01 01 01 01 01 01 01 01 01 01 01 01 01 01 01 01 01 01 