01 01 01 01 01 01 01 01 01 01 01 01 01 01 01 01 01 01 
01 08 01 10 00 00 01 00 00 00 01 00 00 00 00 00 00 01 
01 12 01 06 01 00 01 00 07 00 01 00 00 00 00 00 00 01 
01 00 01 01 01 00 01 00 08 00 01 00 08 00 00 07 07 01 
01 00 00 00 00 00 01 00 02 00 01 03 03 03 03 07 07 01 
01 00 01 01 01 01 01 00 02 00 01 03 03 03 03 03 03 01 
01 00 01 00 00 00 00 00 02 00 01 03 03 03 02 02 02 01 
01 00 01 00 01 01 01 02 02 00 01 03 03 09 09 09 09 01 
01 00 01 00 00 11 01 02 02 00 01 03 03 09 09 09 09 01 
01 00 00 01 01 01 01 00 00 00 00 00 00 02 02 02 02 01 
01 00 00 04 00 00 00 00 08 01 01 01 01 01 01 01 05 01 
01 01 01 01 01 01 01 01 01 01 01 01 01 01 01 01 01 01 