01 01 01 01 01 01 01 01 01 01 01 01 01 01 01 01 01 01 
01 00 00 00 00 07 00 03 12 03 00 00 00 07 00 00 00 01 
01 03 03 03 03 03 03 03 00 03 03 03 03 03 03 03 03 01 
01 01 01 01 01 01 01 03 00 01 01 01 01 01 01 01 01 01 
01 00 08 00 00 00 00 00 00 04 00 00 00 00 00 00 00 01 
01 00 03 01 01 01 01 01 03 01 01 01 01 01 01 03 00 01 
01 00 00 10 00 08 00 01 00 01 00 00 00 00 00 00 00 01 
01 01 01 01 01 03 00 01 00 01 00 03 01 01 01 01 01 01 
01 00 00 00 00 00 00 01 00 01 00 00 00 00 00 00 00 01 
01 00 01 01 01 01 01 01 00 01 01 01 01 01 01 03 00 01 
01 00 00 00 10 00 06 01 00 01 00 00 00 00 00 00 00 01 
01 01 01 01 01 01 01 01 01 01 01 05 01 01 01 01 01 01 