01 01 01 01 01 01 01 01 01 01 01 01 01 01 01 01 01 01 
01 01 03 08 03 09 00 00 00 00 01 01 01 12 03 03 01 01 
01 03 03 03 03 03 00 00 11 00 00 00 01 01 01 03 01 01 
01 03 03 09 03 03 01 01 01 01 01 00 01 03 08 03 01 01 
01 03 03 03 02 02 02 01 01 01 07 03 01 03 03 00 01 01 
01 03 03 02 03 03 03 01 08 08 03 03 01 01 03 00 01 01 
01 03 03 09 03 07 03 01 03 03 01 01 01 01 03 00 01 01 
01 03 03 01 01 01 01 01 03 03 01 01 03 03 03 00 01 01 
01 03 03 03 01 01 00 00 03 03 10 01 03 01 01 10 01 01 
01 00 00 00 10 00 00 00 00 00 00 01 03 01 01 03 01 01 
01 04 01 01 01 01 01 01 01 01 03 03 03 01 01 06 01 01 
01 05 01 01 01 01 01 01 01 01 01 01 01 01 01 01 01 01 