01 01 01 01 01 01 01 01 01 01 01 01 01 01 01 01 01 01 
01 00 00 00 00 00 01 03 03 03 01 08 01 00 09 01 06 01 
01 00 00 08 00 00 01 00 01 03 03 03 03 00 03 01 03 01 
01 00 09 08 09 00 01 00 01 01 01 01 01 01 00 01 09 01 
01 01 01 08 01 01 01 00 01 03 03 03 03 01 00 01 09 01 
01 12 03 00 03 00 00 00 01 03 03 01 03 01 00 02 03 01 
01 01 01 00 01 01 01 01 01 00 00 01 03 01 01 01 00 01 
01 07 01 09 01 08 08 08 08 01 00 01 00 10 00 01 00 01 
01 07 01 09 01 08 08 08 08 01 00 01 00 00 00 01 00 01 
01 04 03 09 03 03 03 03 03 03 00 01 03 01 01 01 00 01 
01 05 01 00 01 00 00 00 00 01 00 01 00 00 00 02 00 01 
01 01 01 01 01 01 01 01 01 01 01 01 01 01 01 01 01 01 