01 01 01 01 01 01 01 01 01 01 01 01 01 01 01 01 01 01 
01 12 03 03 00 07 07 09 00 00 00 07 03 09 09 01 07 01 
01 03 03 03 03 03 03 03 03 00 00 08 03 03 03 01 03 01 
01 03 03 03 03 03 03 01 03 01 01 01 00 00 00 01 03 01 
01 03 03 03 08 03 03 01 03 00 00 00 00 00 00 01 03 01 
01 03 03 03 08 03 03 01 03 00 00 00 00 00 00 01 03 01 
01 03 03 03 08 03 03 01 03 00 00 00 00 00 00 01 03 01 
01 03 03 03 08 03 03 03 03 00 00 00 00 00 00 01 03 01 
01 01 01 03 01 01 03 01 01 01 01 01 01 01 01 01 04 01 
01 03 03 03 03 03 03 03 03 03 03 03 03 03 03 03 00 01 
01 06 01 00 01 00 01 00 01 00 01 00 01 00 01 01 05 01 
01 01 01 01 01 01 01 01 01 01 01 01 01 01 01 01 01 01 