01 01 01 01 01 01 01 01 01 01 01 01 01 01 01 01 01 01 
01 00 00 00 00 00 00 00 01 00 07 00 07 00 07 00 09 01 
01 00 09 00 09 00 09 00 01 03 03 03 03 03 03 03 03 01 
01 00 09 00 09 00 09 00 01 03 03 03 03 03 03 03 03 01 
01 00 01 00 01 00 01 00 01 03 02 02 02 02 02 03 03 01 
01 00 01 00 01 00 01 00 01 03 03 00 10 00 02 03 03 01 
01 00 01 00 01 00 01 02 01 02 02 00 00 00 02 02 02 01 
01 00 02 00 02 00 02 00 00 00 02 03 03 03 03 00 00 01 
01 12 02 00 02 00 02 00 09 00 02 03 03 03 03 10 00 01 
01 02 02 02 02 02 02 00 01 00 02 03 03 03 03 01 04 01 
01 10 00 10 00 06 02 00 01 00 02 03 03 03 03 01 05 01 
01 01 01 01 01 01 01 01 01 01 01 01 01 01 01 01 01 01 