01 01 01 01 01 01 01 01 01 01 01 01 01 01 01 01 01 01 
01 09 09 01 03 03 03 03 03 03 03 03 03 03 03 09 00 01 
01 03 03 01 03 01 01 01 01 01 01 01 01 01 01 01 00 01 
01 00 00 01 08 03 03 03 03 03 09 03 01 03 07 01 00 01 
01 00 00 01 08 01 01 01 01 01 01 03 01 03 03 01 10 01 
01 00 00 01 08 03 03 03 03 08 00 03 01 08 03 01 00 01 
01 00 12 01 03 03 01 01 01 01 00 03 01 03 03 01 00 01 
01 00 01 01 03 01 01 00 00 00 11 00 04 03 03 01 10 01 
01 00 03 03 03 03 01 01 01 01 01 03 01 03 05 01 00 01 
01 00 01 01 03 03 01 03 03 08 08 08 01 01 01 01 00 01 
01 00 10 10 01 01 01 06 03 03 03 03 03 03 03 03 03 01 
01 01 01 01 01 01 01 01 01 01 01 01 01 01 01 01 01 01 