01 01 01 01 01 01 01 01 01 01 01 01 01 01 01 01 01 01 
01 12 08 00 00 00 00 00 00 00 08 01 11 11 11 11 11 01 
01 01 01 01 01 01 01 03 03 03 03 03 03 03 03 03 03 01 
01 01 01 08 01 01 01 03 03 03 03 03 03 03 03 03 03 01 
01 01 07 03 03 03 03 03 01 03 07 03 03 03 03 03 03 01 
01 01 03 03 03 03 03 03 01 03 03 03 03 03 03 09 09 01 
01 02 03 02 02 02 01 03 01 03 03 03 03 03 03 03 03 01 
01 00 00 00 00 00 04 03 03 03 03 01 01 01 01 00 00 01 
01 03 01 03 03 01 01 01 01 00 05 01 08 08 01 00 00 01 
01 01 01 01 01 01 03 03 03 01 01 01 03 03 01 00 00 01 
01 06 10 00 00 00 03 03 03 00 00 00 03 03 00 02 08 01 
01 01 01 01 01 01 01 01 01 01 01 01 01 01 01 01 01 01 