01 01 01 01 01 01 01 01 01 01 01 01 01 01 01 01 01 01 
01 01 01 01 01 03 12 01 03 03 03 03 03 03 08 00 02 01 
01 03 01 01 03 03 03 08 03 03 03 03 03 03 01 09 02 01 
01 03 03 03 03 01 03 03 01 03 03 03 03 03 01 04 05 01 
01 03 03 09 01 01 01 00 02 02 03 03 01 01 01 09 09 01 
01 03 03 03 03 03 03 09 11 02 03 03 01 10 01 02 09 01 
01 01 01 01 02 09 01 01 11 02 03 03 01 10 01 09 09 01 
01 03 03 03 03 03 02 02 02 02 03 03 01 10 01 02 02 01 
01 02 02 02 02 02 01 03 03 03 08 00 03 10 01 09 02 01 
01 03 03 03 03 03 01 03 03 03 01 00 03 10 01 09 09 01 
01 01 06 01 03 01 03 03 01 01 01 09 00 10 09 02 09 01 
01 01 01 01 01 01 01 01 01 01 01 01 01 01 01 01 01 01 