01 01 01 01 01 01 01 01 01 01 01 01 01 01 01 01 01 01 
01 00 00 00 00 00 00 00 00 00 00 00 00 00 00 03 07 01 
01 00 00 00 00 01 00 00 00 00 00 01 00 00 00 01 04 01 
01 00 00 00 00 01 00 00 00 00 00 01 00 00 00 01 00 01 
01 00 00 00 00 01 00 00 00 00 00 01 00 00 00 01 00 01 
01 00 00 00 00 01 00 00 06 00 00 01 11 00 00 01 00 01 
01 00 12 00 00 01 00 00 03 00 00 01 00 00 00 01 00 01 
01 00 00 00 00 01 00 00 00 00 00 01 00 00 00 01 00 01 
01 00 00 00 00 01 00 00 00 00 00 01 00 00 00 01 00 01 
01 00 00 00 00 01 00 00 00 00 00 01 00 00 00 01 00 01 
01 00 00 00 00 00 00 00 00 00 00 00 00 00 00 01 00 01 
01 01 01 01 01 01 01 01 01 01 01 01 01 01 01 01 05 01 