01 01 01 01 01 01 01 01 01 01 01 01 01 01 01 01 01 01 
01 00 00 00 02 02 02 00 00 00 00 00 00 03 02 02 00 01 
01 00 02 00 00 00 00 00 02 00 02 02 02 00 00 03 00 01 
01 00 02 00 02 02 02 02 02 00 02 00 02 02 00 02 00 01 
01 00 02 00 00 00 09 00 00 00 02 00 00 00 00 02 00 01 
01 00 02 00 02 02 02 02 02 02 02 00 02 00 09 10 00 01 
01 00 09 00 02 00 00 00 00 00 02 00 02 00 02 00 00 01 
01 00 02 00 02 02 02 02 02 00 02 00 02 00 02 02 02 01 
01 00 02 03 00 00 10 00 02 00 00 09 03 00 02 07 00 01 
01 00 02 00 02 02 02 00 02 03 02 02 03 00 02 02 00 01 
01 12 02 00 00 00 02 00 00 03 03 02 03 09 09 00 00 01 
01 01 01 01 01 01 01 01 01 01 05 01 01 01 01 01 01 01 