01 01 01 01 01 01 01 01 01 01 01 01 01 01 01 01 01 01 
01 03 03 03 03 03 03 03 03 03 03 03 03 03 03 03 03 01 
01 00 00 00 00 00 00 00 00 00 00 00 00 00 00 00 00 01 
01 00 00 00 00 09 00 09 00 09 00 00 12 00 00 00 00 01 
01 02 02 00 02 02 02 01 01 01 01 01 01 01 01 01 01 01 
01 02 02 00 02 02 02 00 00 00 00 00 00 00 00 00 00 01 
01 02 02 00 02 02 02 00 03 03 00 00 00 07 00 00 00 01 
01 02 02 02 02 02 02 00 03 03 00 07 03 01 00 00 00 01 
01 02 02 02 02 02 02 00 03 03 00 01 01 01 00 00 00 01 
01 02 02 02 02 02 02 00 03 03 00 00 00 00 00 00 00 01 
01 00 00 00 00 00 00 00 00 00 00 01 02 02 02 02 02 01 
01 01 01 01 01 01 01 01 01 01 05 01 01 01 01 01 01 01 