01 01 01 01 01 01 01 01 01 01 01 01 01 01 01 01 01 01 
01 00 08 00 00 00 12 01 03 03 03 03 03 00 00 00 00 01 
01 00 02 02 02 02 02 01 03 07 03 07 04 00 00 00 00 01 
01 00 02 02 02 02 02 01 02 02 02 02 02 00 00 00 00 01 
01 00 02 02 02 02 02 01 09 00 00 00 00 00 00 00 00 01 
01 00 02 02 02 02 02 01 03 00 00 00 00 00 00 00 00 01 
01 00 02 02 02 02 02 01 02 02 00 00 00 00 00 00 00 01 
01 00 02 02 02 02 02 01 06 02 00 00 00 00 00 00 00 01 
01 00 02 02 02 02 02 01 02 02 00 00 00 00 00 00 00 01 
01 09 08 09 08 09 08 02 00 00 00 00 00 00 00 00 00 01 
01 08 09 08 09 08 09 02 03 03 03 03 03 03 03 03 03 01 
01 01 01 01 01 01 01 01 01 01 01 01 01 01 01 05 01 01 