01 01 01 01 01 01 01 01 01 01 01 01 01 01 01 01 01 01 
01 00 08 03 03 03 03 03 03 03 03 09 09 03 02 00 10 01 
01 00 03 03 06 00 03 03 03 03 03 03 03 03 02 00 00 01 
01 00 00 03 00 00 03 07 03 03 03 03 03 03 02 02 02 01 
01 10 00 03 00 00 03 07 03 03 03 03 03 03 02 00 00 01 
01 02 02 02 02 00 12 07 00 00 00 02 02 02 02 00 00 01 
01 03 03 03 02 02 02 04 02 02 00 00 00 00 03 03 03 01 
01 03 07 03 00 00 00 00 00 00 00 00 00 00 03 07 03 01 
01 03 07 03 03 03 03 03 03 03 03 03 03 03 03 07 03 01 
01 03 07 03 03 03 03 03 03 03 03 03 03 03 03 07 03 01 
01 01 01 01 01 01 03 05 03 01 01 03 01 03 01 03 01 01 
01 01 01 01 01 01 01 01 01 01 01 01 01 01 01 01 01 01 