01 01 01 01 01 01 01 01 01 01 01 01 01 01 01 01 01 01 
01 00 07 00 00 00 09 09 00 00 00 00 03 00 00 00 09 01 
01 03 03 07 03 00 09 03 03 00 03 00 00 00 00 03 03 01 
01 00 02 02 00 00 03 00 00 00 03 01 00 03 00 02 02 01 
01 03 00 00 00 03 07 03 00 03 07 00 01 03 02 02 06 01 
01 00 12 02 02 03 02 00 00 00 02 00 01 03 07 03 03 01 
01 03 03 00 02 03 00 00 00 07 03 03 00 03 02 02 02 01 
01 00 00 00 07 03 00 00 01 02 02 00 00 00 00 00 03 01 
01 00 03 00 02 02 02 00 00 00 00 03 00 00 03 00 00 01 
01 00 00 00 03 03 03 00 03 03 03 00 04 00 00 00 03 01 
01 02 02 02 02 02 02 02 02 02 02 02 05 02 02 02 02 01 
01 01 01 01 01 01 01 01 01 01 01 01 01 01 01 01 01 01 