01 01 01 01 01 01 01 01 01 01 01 01 01 01 01 01 01 01 
01 03 03 03 03 03 01 00 08 03 03 03 01 09 03 03 03 01 
01 03 03 03 03 03 01 00 01 03 03 03 01 03 03 06 03 01 
01 03 03 03 03 03 01 00 01 03 03 03 02 00 03 03 03 01 
01 01 03 01 01 01 01 09 01 03 03 03 01 01 00 03 00 01 
01 01 00 00 02 09 09 09 01 03 03 03 01 00 00 03 00 01 
01 01 00 00 01 01 01 02 01 03 03 03 01 00 10 03 00 01 
01 01 00 00 00 01 01 03 01 03 03 09 01 00 00 03 00 01 
01 01 04 01 00 01 01 01 01 03 03 03 01 08 00 03 00 01 
01 01 00 07 00 01 12 03 03 03 03 03 01 03 03 03 00 01 
01 01 01 01 05 01 03 03 03 03 03 03 02 00 00 00 00 01 
01 01 01 01 01 01 01 01 01 01 01 01 01 01 01 01 01 01 